10
// Высота
10
// Длинна
3
// колличество жизней пакмэна
##########
#@.....A@#
####.....#
#..#...#.#
#..#A.#..#
#..#.#...#
##...#.###
##.###...#
#o..#..#A#
##########